NO ./assets/example/north.png
SO ./assets/example/south.png
WE ./assets/example/west.png
EA ./assets/example/east.png
DO ./assets/example/door.png
SP ./assets/test/sprite.png

F 50,25,25
C 25,50,25

        1111111111111111111111111
        1000000000110000000000001
        1011000001110000000000001
        1001000000D00000000000001
111111111011000001110000000000001
10000000001100000111D111111111111
11110111111111011100000010001
11110111111111011101010010001
110000001101010111000000D0001
1000000000000000D000000010001
10000000000000001101010010001
11000001110101011111011110E0111
11110111 1110101 101111010001
11111111 1111111 111111111111
