NO ./assets/north_test.png
SO ./assets/south_test.png
WE ./assets/west_test.png
EA ./assets/east_test.png

F 220,100,0
C 225,30,0

        1111111111111111111111111
        1000000000110000000000001
        1011000001110000S00000001
        1001000000000000000000001
111111111011000001110000000S00001
100000000011000001110111111111111
1111D111111111011100000010001
11110111111111D11101010010001
11000000110101011100000010001
1000S000000000001100000010001
10000000000000001101010010001
11000001110101011111011110N0111
11110111 1110101 101111010001
11111111 1111111 111111111111
