WE ./assets/test/west.png
NO ./assets/test/north.png
F 50,25,25
SO ./assets/test/south.png
EA ./assets/test/east.png
DO ./assets/test/door.png
SP ./assets/example/weapon_atlas.png

C 25,50,25

11111111111111111111111111
11000100111110000000111101
11001000D00011000000111101
1100D000100000100000111101
100110011000001000000D01D1
10110001000000010000010001
10D00001100000011000010001
10110000100000001100001001
10010000010000000110001111
100D0000010000000010000111
10011000001000000011000001
11111000001000000110000001
1111100000D000011000000001
11001000001000110000000111
10001100011000010000111101
100001000110E00D0001000001
11000110001100110010000001
10100010000011100010000001
10110011000000000010000001
1011000D000000000011000001
1D100001000001110001000001
10000001000001111000100001
1000001000000D000100110011
100000D0000001000D00010001
10000010000001101100110001
11111111111111111111111111
