WE ./assets/example/west.png
NO ./assets/example/north.png
F 50,25,25
SO ./assets/example/south.png
EA ./assets/example/east.png
DO ./assets/example/door.png
SP ./assets/example/weapon_atlas.png

C 25,50,25


        1111111111111111111111111
        1000000000000000D00000001
        1111111111111111111111111
        1000000000110000000000001
        1011000001110000000000001
        1001000000D00000W00000001
111111111011000001110000000000001
10000000001100000111D111111111111
11110111111111011100000010001
11110111111111D11101010010001
110000001101010111000000D0001
1000000000000000D000000010001
10000000000000001101010010001
1100000111010101111101111000111
11110111 1110101 101111010001
11111111 1111111 111111111111
