
    
F 140,195,209
C 118,170,236

WE assets/test/west.png
NO assets/test/north.png
EA assets/test/east.png
SO assets/test/south.png
DO assets/test/door.png

111111111111111111111111111111111111111111111111111111111111111111111111111111111111111111111111111111
111000000111111000001000011000110001110000000011000110000101100010000111011111000011111000000000100001
10110000100000000000100000011110000111000000000000001000100011111000110000D001000000110000000000D00001
10010000D0000000001100000000111001111000011000000000110110001111000011000110001000000D0001D1D111100011
10110001100000011D100000000011111100D00011110000000001111111111000001111110000D00000110011000111101101
1100000110000111000000000011100000001100D00010000000000011000011001D1111111101100000D00010000111111001
10000011111D100000000011D100000000000D011000D000111000000D000011111011000111D1000001100011111111011001
10001110000000000000110000000011100001111000111D111100000100011110000D00010000001D11000001100011011001
11D11110000000000000100000001D111D10000111D1111000001100010011001000010010000000D000000000000010001001
110000110011D1000000D000001D10000011000110001100000001D11100D00010000111100000011000000000000010001001
10000001D11001100000100001100000000D000D000011111110000000001100100000110000000D00000000100000D0001001
1000000000000001100100001100000000011001000111110011000000000D001000011100000001000001D111000010001001
10000000000000000111000010001D1100001D11111111100011000000000100110011111000000D0001110001000100010001
101D10000001D10000000001100110001000001111000110001100000000110011D10000100000111110000001000D000D0001
110011000010001000000001000D00011000000110000011110000001D1D10000000000001D101111100000000101100010001
11000D000110001100000001000111D100000001000000110000000010000000000000000001D10011000000001D1100111D11
11000110001100110000000D0011110000000011000001110000000110000000011111D1000000000D0001D10000111D111001
101000110000111110000011111110000000111000000111000001110000000111111000100111000110110110001000011001
1011000110000111111101111100110001D1000000001001101D1110000001100011100001D1111001101000D000D000010001
10110000100001100001D10011000100110000000000D001101000000000010000111D10000000101100100011011000110001
111100001111100000000000010001011000000110011001001100000000010000100011000001111000110011001111000001
101000011111000000000000011011011000011001111011000D00000000010000100001100111111000010110000000000001
10011110011000000000000000111000D00001000001110000010011D100110000D0001111110001100011D110000000000001
10011000001101111000000000111000110001100001100000011110001110000011111001100001111D1001100000001D1111
10110000011111001100000000111100011000111111100000111100000111001D111000011001D11110000011000001100111
10D0000111011000011111D110110011001110001111110001100D00000111D110011000011111011100000001111111000001
1010001100011000001100011011000100001000011101D110000100001100000001111D111100001100111000011111100001
110000110000D00000000001000100011000010000110000000001000110000000111110001100011111100100011000011001
11000001D10110000000001000010000110001D10001000110001000011000000110010000011D110011000011110000001101
1110000001D111000001D1000001100001D10001100011D111111000001D100111000110000010000001100011100000001001
1111D10000011111111100000011000000011000110000000111000000001D11110000110000000000001D1111100000011001
111000100001100011100001D11000000000110001000000011100000000001111110001100000000000001111110001100001
11100011000010000111111100000000000001000D000000111000011000000D00011000110000111000000111001111000001
1011100011000100111110000000001D1000001111000011001000011D1000010000D0000D000100D0000011110000000001D1
100011000110001D1000000000011100110000011000011000D000110010000011011000011010001000010001000000111001
10000110001000000000000001D100000011000000000100001000100001100001100000001110001000010001000000110001
1000001000110001100000001000000000001100000011111100011000001D1000000000000110010000011001100000D00001
10000011001100111D100001100000000000011000011111000001000000001100000110000111110000000111100001100001
101D10001D10011000110001100011D1000001111110011000011100000000011001D111000111000000000000000011100001
11001100000000100001000010011001000011001100001101D110000000001101110001000D00000000000000011100001001
1000010000000010011000001111000D0000100001000001D10001100000011000D00001000100000000000000011000011D11
11000110000001111100000011110011000010000100000000000111110011000011000111100000001D110000001000011001
111000110001D11110000001111100D0000011000D00000000000100011111100001100011100000111001100000D000011001
10D00001D11100011000111000110010000000111110000000001000001110111000110000000001100000011000100000D001
111000000000000011110000001000100000000111111100000010000011000011000110000000010000000001D11100001111
11000000000000000000000000D000D000000001110001100001100011110000010000D0000000011000000000011111101111
1000000011100000000000000110001100000011100000D00001000100111D1011000011000001111110000000001000111111
1000001D1111000000000001110000011000110111000010000100110011000111100001100111011111000000001100011111
1011D1100000110000001D111000000001D1000011D10010000D001000100000011D1000111100011001000000000100111101
11000000000001D10000D0000000000000000001100D011000011100011000000D00D000111100010000100000000011101101
100000011110000110001100000001000011000D00010110000000000110000001001000111111100000100111110000000D01
10011D1100110000D0000100000011D11D11D111001100D000000000001D10001100D000D00011000000100110011000001111
111100000011000010000100000010001000001111100011000110000000011111001001100000000001100110000110111111
11000000001100010000010000010000000000111110001100111110000000111111101100001110000D0000D0000001100011
10000001D100000D00000100000D00001D110110011D1111001000110000011000111110000110011111100010000000000011
110000110000000100001100000100011001D1000110011000100001111D1000000110000001000011111D1011000000001111
101111110000000010001100001100011000000001000000000100011110000000010000000D000011000011111000001D1001
10001111110000001000011000110000D0000000110000110001001100D00000001100000001111100000001101D1111100001
1000100001D100001000000111110000110011D1110001111D1100110010000000100000001111100000000100000111000011
1000100000010000D00000000111D1101101100010000100001000110001000000D00001D1001100000001100000001111D111
1001000000010001100000000110001110001000010001000000000100010000011000110000011011D1110000000111110001
100D000000110001100000000D0000000000100011100010000000010000110001000110000011111000111000001000000001
1001000000D00000110000000100000000001101101100011000000D0000001D10000100001100110001111D11110000000001
1010000001100000001100000D0001110000011100010000010000010000000000000100011000110011000011100001110001
111000001100000000011000110011011000011100011000011000100000000000001000011000011D10000000001111110011
111000111000000000001100D0001001100001111000100000D0001000000000000010000011100110000000000111000D0011
11111D1000000000000001D11001000D00000110011001100011011001D1000000011000000011111100000000011000010001
111110000000011D1D100001111100010000011000D0000100110111D1011000001110111000011111D1000000011000110001
11111000000110000011000011000001000000100011000011110000000011001D10011111101111000110000011111D110001
1111110000110000000D00001000000111000011000110001111000000001111000000D000011011000001111111100011D101
1100011000010000000110001100000000100001000011D1100D000000011110000000100000000D000001111000D000100111
1100000100001D110000D00001D100000001000010000000000100000011001000000011000000110000011100001000100011
1000000100000000100010000001100000110000100000000000100000100001D110000D000011100000011100000111000001
1100000010000000D000D00000000111D110000010000010000010000010000000010001000110000000110110000011000001
111000001000001110001100000000110000000010001D110000011000010000000D0001100110000000100010000000000001
10110000D000011000000D00000000000000000010011001000000110001000001110001100110000001100001100000000001
100D000110001100000001000011000000000001000100010000000D0011001D11000000100011D101111000001D1111000001
100100010000110000000110110110000000000D00010011000000011111011000000000100000000011110000001111D10001
10100001100001D1D10000111000100000000001000D0010000000111100010000000000110001100011011000001110001111
1010000011100000001000000000110011100010001100100001D100110001000001D10001D11111D11000D000011110000111
10D000000011000001100000000001D110111D1000100011111000001000110000010011000000000100001000110011000111
1011000S00011001D10000000000000000000000001000111000000010001000000D0001000000000000001000D00011011111
100100000001101100000000110000000000000001100111100000110000100000010001100000000000010000100111110001
10001000001000100000001D11100000000000000100010010000110000110000001100011000000001111000011D101100001
1000D0000110001000000110001100011000000011111000010001100001111110011000011100000111000001110000110111
100011000110001100000D0000111D111100000111110000010000111011111001110000000110000100000001110001111101
100001100011101100000110111110000110011111100000001000001D100110000000000000D0000100000011111D11111001
1000001D10001D11110001111000D000011111000110000000110000000000D000000000000111001000000010000000110001
100000001000001111111111000011D111110000001100000001000000000011000000111D1111111100000110000000111D11
111100000100001100011111100000000011000000001100000100000000000100001D10000011111110000100000001111001
1001110001000001000000001D1000000111111110000D00001000000011D11111D10000000010011011000110001D10011001
100001D111000001000000000011000011111000100001000010000001100111100000000000100D000D00001D111000001101
100000011100001100000000000111111011000011111000011000000D00000D00000000000100010001000000000000011111
1100000001111D1000001D10000011100001100111110000010000000100000110000000000110010011000000000000111111
11100000111110000000D0010000111000011D1001100001100000011100000010000000001111110110000000111100D00011
11100011111100000000100100011111D111100000110111000001111110000011000000111001111100000111001100100001
110001001111000000011001000D00000110000001111100000011001111000011000111111000110000001100000D00100001
11000D0011011000000110110011000000100000011110000000D000D00D00000D000D00001000100000011000000100110001
1000010010001000000111000010000000100000100010000000100110010000010001000100011000000D0000000100010001
10000101100001100000000000110000010000001000110000011001000100000D00011111000D000000010001100011001101
100000110000001111110000000110000100000010000010000100010011000001100011000001000000100011110001000011
111111111111111111111111111111111111111111111111111111111111111111111111111111111111111111111111111111

