WE /Users/apena-ba/Proyectos/Proyectos42/nivel4/cub3d/assets/example2/west.png
C 225,30,0
NO /Users/apena-ba/Proyectos/Proyectos42/nivel4/cub3d/assets/example2/north.png

F 1,1,1
EA /Users/apena-ba/Proyectos/Proyectos42/nivel4/cub3d/assets/example2/east.png

SO /Users/apena-ba/Proyectos/Proyectos42/nivel4/cub3d/assets/example2/south.png
SP /Users/apena-ba/Proyectos/Proyectos42/nivel4/cub3d/assets/example2/sprite.png
DO /Users/apena-ba/Proyectos/Proyectos42/nivel4/cub3d/assets/example2/door.png

11111111111111
100000S0000001
10000000000001
100000C0000001
10000000000001
11111111111111